######################
# O   X         O    #
# O  X      X        #######
#                          #
#    ###               X  O#
#      #          ##########
#      X        ## O #
# ###         ##     #
#          ###       #
#                    #
#          #         #
#          #     O   #
#   XP     # #       #
#           #     #  #
######################
