###########
#         #
#     X   #
#      O  #
#    ###  #
#   X  #  #
#         #
# P      O#
#    ######
#         #
####X### ##
#         #
#     #   #
#O#########
###########
