#####################
#                   #
# O   X        O    #
# O  X     X        #
#    P    # #       #
#          #     #  #
#####################
