########
#OPX   #
#      #
# O X  #
#      #
########
