###########################
#                         #
#     X        X          #
#                  #      #
#    ###          #       #
#   X  #         #   X X  #
#               #         #
# ###        ##############
#         ###             #
# P                       #
#         ######          #
#         #O    #         #
#         ###             #
#         #O   O #      #O#
###########################
