#####
#   #
# O #
# X #
# P #
#   #
#####
